5
1 2 3 4 5
6 7 8 9 4
3 4 5 6 7
3 2 3 4 5
6 5 7 8 9